SO    textures/J_AND_K_NY_POLICE-SO.xpm

WE    textures/montadas_en_caballo_juegos-WE.xpm

NO    textures/miguel_concentrado-NO.xpm

EA   textures/firts_day_of_the_year_of_college-EA.xpm


F  140, 139, 139


C 154, 209,   230



11111111111111111          11111111111111111
10000010000000001          10000000000000001
10000100000010001          10000011110000001
100000000000W1001          10000000000000001
111111111100000111111111111000001111111111111111
         1000000000000000000000001
         1000000000000000000010001
         1111111111111111111111111